{
    "map": [
        ".  #:   # :    ",
        " #:#a##:# ####:",
        " :        #    ",
        "####:####### ##",
        "  :#   : :   #+",
        " # # # # ##### ",
        "  :###:# #     ",
        ":# #  #  ###:##",
        " # #  # ####:##",
        " # #  # #      ",
        " # :  : #      ",
        " : ###########:",
        " #   # :      :",
        " ### ####:#####",
        "   # :       : "
    ],
    "robots": {
        "a": {
            "type": "orientation"
        }
    }
}
