p  #:   # :    
 #:#r##:# ####:
 :        #    
####:####### ##
  :#   : :   #g
 # # # # ##### 
  :###:# #     
:# #  #  ###:##
 # #  # ####:##
 # #  # #      
 # :  : #      
 : ###########:
 #   # :      :
 ### ####:#####
   # :       : 
