p  #:  t# :    
 #:#t##:# ####:
 :    t   #    
####:####### ##
  :#   : :  t#g
 # # # # ##### 
  :###:# #     
:# #  #  ###:##
 # #  # ####:##
 # #  #t#      
 # :  : #  t   
 : ###########:
 #   # :  t   :
 ### ####:#####
   # :       : 
